Player	Pick
Root	Kelsey
Peggy	Kelsey
Christine	Jade
Leah	Megan
Goldman	Tara
Annie	Britt
Devin	Becca
Deri	Kelsey
Courtney	Britt
Nancy	Jade
Savello	Ashley I
Marie	Kelsey
Kate	Britt
Stacey	Tracy
Megan	Kelsey
Amanda	Tracy
Stef	Britt
Meggie	Whitney
Sarah	Whitney
Jenna	Alissa
